[
    [0,0, 0, 0, 0, 0, 0, 0, 10, 0, 0, 0, 0, 0, 0, 0],
    [0,0, 0, 0, 0, 0, 0, 0, 10, 0, 0, 0, 0, 0, 0, 0],
    [0,0, 0, 0, 0, 0, 0, 0, 10, 0, [0,14], 0, 0, 0, 0, 0],
    [0,0, 0, 0, 0, 0, 0, 0, [10], 0, 0, 0, 0, 0, 0, 0],
    [0,0, 0, 0, 0, 0, 0, 0, 10, 0, 0, 0, 0, 0, 0, 0],
    [0,0, 0, 0, 0, 0, 0, [0,13], 10, [0,12], [0,12], [0,12], [0], [0], [0], [0]],
    [9,9, 9, 9, 9, 9, 9, 9, 1, 9, 9, 9, 9, 9, 9, 9],
    [0,0, 0, 0, 0, 0, 0, 0, 10, 0, 0, 0, 0, 0, 0, 0],
    [0,0, 0, 0, 0, 0, 0, 0, 10, 0, 2, 2, 0, 0, 0, 0],
    [0,0, 11, 11, 11, 11, 0, 0, 10, 0, 2, 2, 0, 0, 0, 0],
    [0,0, 11, [11, 5], [11,8], 11, 0, 0, 10, 0, 0, 0, 0, 0, 0, 0],
    [0,0, 11, [2], [2], 11, 0, 0, 10, 0, 0, 0, 0, 0, 0, 0],
    [0,0, 11, [11,6], [11,7], 11, 0, 0, 10, 0, 0, 0, 0, 0, 0, 0],
    [0,0, 11, 11, 11, 11, 0, 0, [10], 0, 0, 0, 0, 0, 0, 0],
    [0,0, 0, 0, 0, 0, 0, 0, 10, 0, 0, 0, 0, 0, [0], 0],
    [0,0, 0, 0, 0, 0, 0, 0, 10, 0, 0, [0,12], [0,14], 0, [0], 0]
]